ATL=Atlanta, GA, USA
ORD=Chicago, IL, USA
LHR=London, England, United Kingdom
HND=Tokyo, Japan
LAX=Los Angeles, CA, USA
CDG=Paris, France
DFW=Dallas/Ft Worth, TX, USA
FRA=Frankfurt, Germany
PEK=Beijing, China
MAD=Madrid, Spain
DEN=Denver, CO, USA
JFK=New York, NY, USA
AMS=Amsterdam, Netherlands
LAS=Las Vegas, NV, USA
HKG=Hong Kong, Hong Kong
IAH=Houston, TX, USA
PHX=Phoenix, AZ, USA
BKK=Bangkok, Thailand
SIN=Singapore, Singapore
EWR=Newark, NJ, USA
MCO=Orlando, FL, USA
DTW=Detroit, MI, USA
SFO=San Francisco, CA, USA
NRT=Tokyo, Japan
LGW=London, England, United Kingdom
MSP=Minneapolis, MN, USA
DXB=Dubai, United Arab Emirates
MUC=Munich, Germany
MIA=Miami, FL, USA
CLT=Charlotte, NC, USA
FCO=Rome, Italy
BCN=Barcelona, Spain
SYD=Sydney, New South Wales, Australia
PHL=Philadelphia, PA, USA
CGK=Jakarta, Indonesia
YYZ=Toronto, Ontario, Canada
ICN=Incheon [Seoul], South Korea
SEA=Seattle, WA, USA
CAN=Guangzhou, China
PVG=Shanghai, China
BOS=Boston, MA, USA
KUL=Kuala Lumpur, Malaysia
ORY=Paris, France
MEX=Mexico City, Distrito Federal, Mexico
IST=Istanbul, Turkey
BOM=Bombay (Mumbai), India
LGA=New York, NY, USA
IAD=Washington, DC, USA
MXP=Milan, Italy
STN=London, England, United Kingdom
TPE=Taipei, Taiwan
DEL=Delhi, India
DUB=Dublin, Ireland
PMI=Palma Mallorca, Mallorca Island, Spain